0,241,0,0,0,242,0,245,-1,243,0,0,247,-1,240,0,0,0,0,0
0,0,243,0,0,0,0,0,240,0,0,0,0,241,0,0,247,0,0,0
241,0,0,246,0,0,242,0,0,0,244,0,0,0,0,243,0,0,240,0
0,22,0,0,0,43,44,0,0,0,0,0,0,0,0,0,0,0,0,0
0,0,25,26,27,0,0,0,0,21,0,0,0,0,0,0,0,0,0,0
0,0,0,0,0,42,0,0,0,0,0,0,0,0,0,0,0,0,0,0
0,23,0,0,0,0,0,0,1,0,0,0,0,0,0,0,0,0,0,0
0,0,0,0,0,41,0,0,0,22,0,0,0,0,0,0,0,0,0,0
0,0,0,0,0,0,0,0,0,0,0,0,0,0,0,0,0,0,0,0
0,0,0,0,0,0,0,0,0,0,0,0,0,0,0,0,0,0,0,0
