303,304,305,1,2,111,24,173,203,80,313,4
333,334,335,405,51,171,144,234,204,50,33,34
31,32,51,142,144,173,204,174,20,113,63,64
61,142,144,205,174,203,204,201,140,92,93,94
144,174,204,203,204,233,234,201,206,140,171,142
233,204,203,233,174,204,174,174,204,233,203,204
203,201,20,21,21,22,21,23,24,174,233,204
30,31,32,33,34,32,33,34,111,24,204,234
60,61,62,63,64,62,63,64,94,62,24,173
90,91,92,93,94,92,93,94,91,92,93,24
