134,133,70,2,3,1,20,108,171,172,173,174
10,12,73,22,23,20,83,190,191,192,193,194
30,40,41,42,20,60,209,210,211,212,213,214
136,92,33,62,63,20,229,230,231,232,233,234
151,12,152,2,60,4,249,250,251,252,253,254
22,20,21,31,112,24,269,270,271,272,273,43
2,40,41,150,73,110,112,41,5,22,42,43
1,60,61,110,92,135,53,61,60,61,62,63
1,80,81,71,14,113,70,81,80,81,82,83
21,100,101,102,130,133,70,101,100,101,102,103
