24,5,17,18,5,5,10,5,5,5
17,5,11,5,17,24,5,1,5,5
10,24,15,5,14,8,5,5,5,5
5,5,10,18,5,5,17,5,5,5
20,24,20,5,5,5,10,5,5,5
